************************************
*       *        *   *    *        *
*       *        *   *    *        *
*       *        *   *    *        *
*****   ******   *        *        *
*   *   *    *   *        *        *
*   *   *    *   *        *        *
*   *   *    *   *   ******        *
*   *   *                 *        *
*   *   *                 *        *
*   *   *                 *        *
*   *   *    *****   *    *        *
*                *   *             *
*                *   *             *
*                *   *             *
*   *********    *   *    **********
*           *        *    *        *
*           *        *    *        *
*           *        *    *        *
*****   *   ******   ******        *
*       *   *                      *
*       *   *                      *
*       *   *                      *
*       *   *     **************   *
*   *****   *     *                *
*   *   *   *     *                *
*****   *   *     ********     *   *
*                        *     *   *
*                        *     *   *
*                        *     *   *
************************************