************************************
*       *        *   *    *        *
*       *        *   *    *        *
*       *        *   *    *        *
*****   ******   *        *        *
*   *   *    *   *        *        *
*   *   *    *   *        *        *
*   *   *    *   *   ******        *
*   *   *                 *        *
*   *   *                 *        *
*   *   *                 *        *
*   *   *    ****    *    *        *
*               *    *             *
*               *    *             *
*               *    *             *
*  **********   *    *     *********
*           *        *     *       *
*           *        *     *       *
*           *        *     *       *
*****   *   *****    *******       *
*       *   *                      *
*       *   *                      *
*       *   *                      *
*       *   *                      *
*   *****   *     **************   *
*   *   *   *     *                *
*****   *   *     *                *
*                 ********         *
*                        *     *   *
*                        *     *   *
************************************